1 1 1 1 1 1 1 1 1 1 1 1 1 1 1 1 1 1 1
1 1 1 1 1 1 1 1 1 1 1 1 1 1 1 1 1 1 1
1 1 1 1 1 1 1 1 1 1 1 1 1 1 1 1 1 1 1
1 1 1 1 1 1 1 0 0 0 0 0 1 1 1 1 1 1 1
1 1 1 1 1 1 1 0 8 12 9 0 1 1 1 1 1 1 1
1 1 1 1 1 1 1 0 15 7 14 0 1 1 1 1 1 1 1
1 1 1 1 1 1 0 0 15 7 14 0 0 1 1 1 1 1 1
1 1 1 1 1 0 0 8 36 7 37 9 0 0 1 1 1 1 1
1 1 1 1 0 0 8 36 5 5 6 37 9 0 0 1 1 1 1
1 1 1 0 0 8 36 5 5 7 7 5 37 9 0 0 1 1 1
1 1 0 0 8 36 5 5 5 5 5 5 6 37 9 0 0 1 1
1 1 0 8 36 7 5 7 7 7 7 6 5 5 37 9 0 1 1
1 1 0 11 19 13 19 13 19 13 19 13 19 13 19 10 0 1 1
1 1 0 0 16 0 16 0 16 0 16 0 16 0 16 0 0 1 1
1 1 0 8 18 12 18 12 18 12 18 12 18 12 18 12 0 1 1
1 1 0 11 19 13 19 13 19 13 19 13 19 13 19 10 0 1 1
1 1 0 0 16 0 16 0 16 0 16 0 16 0 16 0 0 1 1
1 1 0 8 18 12 18 12 18 12 18 12 18 12 18 12 0 1 1
1 1 0 11 19 13 19 13 19 13 19 13 19 13 19 10 0 1 1
1 1 0 0 16 0 16 0 16 0 16 0 16 0 16 0 0 1 1
1 1 0 8 18 12 18 12 18 12 18 12 18 12 18 12 0 1 1
1 1 0 11 19 13 19 13 19 13 19 13 19 13 19 10 0 1 1
1 1 0 0 16 0 16 0 16 0 16 0 16 0 16 0 0 1 1
1 1 0 8 18 12 18 12 18 12 18 12 18 12 18 12 0 1 1
1 1 0 11 19 13 19 13 19 13 19 13 19 13 19 10 0 1 1
1 1 0 0 16 0 16 0 16 0 16 0 16 0 16 0 0 1 1
1 1 0 8 18 12 18 12 18 12 18 12 18 12 18 12 0 1 1
1 1 0 11 19 13 19 13 19 13 19 13 19 13 19 10 0 1 1
1 1 0 0 16 0 16 0 16 0 16 0 16 0 16 0 0 1 1
1 1 0 8 18 12 18 12 18 12 18 12 18 12 18 9 0 1 1
1 1 0 11 13 13 13 13 13 19 13 13 13 13 13 10 0 1 1
0 0 0 0 0 0 0 0 0 16 0 0 0 0 0 0 0 0 0
1 1 1 1 1 0 8 12 12 18 12 12 9 0 0 0 0 20 0
1 1 1 1 1 0 15 5 6 7 7 7 14 0 0 23 17 28 0
0 0 0 0 0 0 15 5 5 5 7 5 14 0 0 0 0 16 0
0 23 26 17 26 17 33 7 7 7 5 5 34 17 17 26 17 28 0
0 0 16 0 16 0 15 7 5 5 6 5 14 0 0 16 0 16 0
0 0 16 0 16 0 15 5 5 7 7 5 14 0 0 16 0 16 0
0 23 31 0 21 0 11 13 13 19 13 13 10 0 0 21 0 21 0
0 0 0 0 0 0 0 0 0 16 0 0 0 0 0 0 0 0 0
1 1 1 1 1 0 8 12 12 18 12 12 9 0 1 1 1 1 1
1 1 1 1 1 0 15 7 5 5 7 6 14 0 1 1 1 1 1
1 1 1 1 1 0 15 5 5 5 7 7 14 0 1 1 1 1 1
1 1 1 1 1 0 15 7 5 6 5 7 14 0 1 1 1 1 1
1 1 1 1 1 0 15 7 5 7 7 5 14 0 1 1 1 1 1
1 1 1 1 1 0 15 5 7 7 5 5 14 0 1 1 1 1 1
1 1 1 1 1 0 11 13 13 19 13 13 10 0 1 1 1 1 1
0 0 0 0 0 0 0 0 0 16 0 0 0 0 0 0 0 0 0
0 29 17 17 17 30 0 29 17 24 17 17 17 17 17 17 17 30 0
0 16 0 0 0 16 0 16 0 16 0 0 0 0 0 0 0 16 0
0 16 0 20 0 16 0 16 0 27 17 30 0 29 17 30 0 16 0
0 16 0 16 0 16 0 16 0 16 0 16 0 21 0 16 0 16 0
0 16 0 27 17 25 17 31 0 16 0 16 0 0 0 16 0 16 0
0 16 0 16 0 0 0 0 0 16 0 32 17 17 26 31 0 16 0
0 16 0 32 17 17 17 30 0 16 0 0 0 0 16 0 0 16 0
0 16 0 0 0 0 0 16 0 16 0 29 17 17 25 22 0 16 0
0 16 0 8 12 9 0 16 0 16 0 16 0 0 0 0 0 16 0
0 21 0 11 13 35 17 31 0 16 0 32 17 17 17 17 17 31 0
0 0 0 0 0 0 0 0 0 16 0 0 0 0 0 0 0 0 0
1 1 1 1 1 0 8 12 12 18 12 12 9 0 1 1 1 1 1
1 1 1 1 1 0 15 7 5 7 5 6 14 0 1 1 1 1 1
1 1 1 1 1 0 15 6 5 7 5 7 14 0 1 1 1 1 1
1 1 1 1 1 0 15 5 7 5 5 5 14 0 1 1 1 1 1
1 1 1 1 1 0 15 7 5 7 5 5 14 0 1 1 1 1 1
1 1 1 1 1 0 15 5 7 7 5 7 14 0 1 1 1 1 1
1 1 1 1 1 0 11 13 13 13 13 13 10 0 1 1 1 1 1
1 1 1 1 1 0 0 0 0 0 0 0 0 0 1 1 1 1 1